28
8
22 22 22 22 22 22 22 22 22 22 22 22 22 22 22 22 22 22 22 22 22 4 0 0 0 0 3 22 
22 19 17 17 17 17 17 17 17 17 17 17 18 22 22 22 22 22 22 22 22 4 0 0 0 0 0 20 
22 4 0 0 0 0 0 0 0 0 0 0 3 22 22 22 22 22 22 22 22 4 0 0 0 1 21 21 
22 4 0 0 0 0 0 0 0 0 0 0 3 22 22 22 22 22 22 22 22 4 0 0 0 3 22 22 
22 4 0 0 0 0 0 0 0 0 0 0 3 22 22 22 22 22 22 22 22 4 23 25 0 3 22 22 
22 4 0 0 0 0 0 0 0 0 0 0 3 22 22 22 22 22 22 22 22 4 0 0 0 3 22 22 
22 4 0 0 0 0 0 0 0 0 0 0 0 17 17 17 17 17 17 17 17 0 0 0 0 3 22 22 
5 21 21 21 21 21 21 21 21 21 21 21 21 21 21 21 21 21 21 21 21 21 21 21 21 21 6 22 
